20 20
100 100
0 0 0 0 0 0 0 0 0 0 0 0 0 0 0 0 0 0 0 0
0 3 3 3 2 2 2 2 2 0 2 2 2 2 2 2 2 2 2 0
0 3 3 3 2 2 2 2 2 0 2 2 2 2 2 2 2 2 2 0
0 3 3 3 2 2 2 2 2 0 2 2 2 2 2 2 2 2 2 0
0 2 2 2 2 2 2 2 2 0 2 2 2 2 2 2 2 2 2 0
0 2 2 2 2 2 2 2 2 0 2 2 2 2 2 2 2 2 2 0
0 2 2 2 2 2 2 2 2 2 2 2 2 2 2 2 2 2 2 0
0 2 2 2 2 2 2 2 2 2 2 2 2 2 2 2 2 2 2 0
0 0 0 0 0 0 0 0 2 2 2 2 2 2 2 2 2 2 2 0
0 2 2 2 2 2 2 2 2 2 2 2 2 2 2 2 2 2 2 0
0 2 2 2 2 2 2 2 2 2 2 2 2 2 2 2 2 1 1 0
0 2 2 2 2 2 2 2 2 2 2 2 2 2 2 2 1 1 1 0
0 4 4 4 4 4 4 4 3 3 3 2 2 2 2 2 1 1 1 0
0 4 1 1 1 1 1 4 3 3 3 2 2 2 2 2 1 1 1 0
0 4 1 1 1 1 1 4 3 3 3 2 2 2 2 2 1 1 1 0
0 4 1 1 1 1 1 3 3 3 3 2 2 2 2 2 1 1 1 0
0 4 1 1 1 1 1 4 3 3 3 2 2 2 2 2 1 1 1 0
0 4 4 4 4 4 4 4 3 3 3 2 2 2 2 2 1 1 1 0
0 2 2 2 2 2 2 2 2 2 2 2 2 2 2 2 1 1 1 0
0 0 0 0 0 0 0 0 0 0 0 0 0 0 0 0 0 0 0 0